type octile
height 12
width 18
.....@..@.........
.....@..@..@@@@@@@
.....@..@..@..@@..
@@@@@@..@@@@..@@..
..........@@......
..........@@......
......@@......@@..
......@@......@@..
..........@@......
..........@@......
..........@@..@@..
..........@@..@@..
